20 10
4 4 4 4 4 4 4 4 4 4 4 4 4 4 4 4 4 4 4 4
4 9 0 0 0 0 0 0 0 0 0 0 0 0 0 0 0 0 9 4
4 0 0 0 0 0 2 0 0 0 0 0 0 0 0 0 0 0 0 4
4 0 0 0 0 4 0 4 4 4 4 0 0 0 0 0 0 0 0 4
4 0 0 0 0 0 0 3 64 8 4 0 0 0 0 0 0 0 0 4
4 0 0 0 0 4 0 4 4 1 4 0 0 0 0 0 0 0 0 4
4 0 0 0 0 73 2 0 0 0 0 0 0 0 0 0 0 0 0 4
4 0 0 0 0 0 0 0 0 0 0 0 0 0 0 0 0 0 0 4
4 9 0 0 0 0 0 0 0 0 0 0 0 0 0 0 0 0 9 4
4 4 4 4 4 4 4 4 4 4 4 4 4 4 4 4 4 4 4 4