20 10
9 0 0 0 0 0 2 0 0 0 0 0 0 63 63 63 3 63 63 9
0 0 0 0 0 0 0 0 2 0 0 0 0 61 64 64 64 61 63 3
0 0 0 0 0 0 2 2 0 0 0 0 0 64 0 0 61 61 0 61
0 0 0 2 2 2 0 0 0 0 0 0 0 61 61 61 61 64 61 64
2 2 2 0 0 0 0 0 0 0 0 0 0 61 61 61 61 61 61 61
0 0 0 0 0 0 0 0 0 0 8 0 0 0 0 0 0 0 0 0
1 4 0 0 0 0 0 5 0 0 0 0 0 0 0 0 0 0 0 0
1 2 0 0 0 0 0 0 5 0 0 0 0 0 0 0 0 0 0 0
4 1 4 0 0 0 0 0 0 5 0 0 0 3 3 3 3 3 3 61
9 0 63 0 0 0 0 0 0 5 0 0 0 5 0 0 0 0 0 9
Ballons
22 54 3
1141 138 0
