21 11
4 4 4 4 4 4 4 4 4 4 4 4 4 4 4 4 4 4 4 4 4
4 9 0 0 0 0 0 0 0 0 0 0 0 0 0 0 0 0 9 4 4
4 0 8 0 0 0 0 0 0 0 0 0 0 0 0 0 0 0 0 4 4
4 0 0 0 0 0 0 0 0 4 4 4 4 4 0 0 0 0 0 4 4
4 0 0 0 4 0 0 0 0 0 0 0 2 0 0 0 0 0 0 4 4
4 0 0 0 0 0 0 0 0 0 0 0 4 0 0 0 0 0 0 4 4
4 0 0 0 0 0 0 0 0 0 0 0 4 0 0 0 0 0 0 4 4
4 0 0 0 4 0 0 0 0 4 0 0 0 0 0 0 0 0 0 4 4
4 9 0 0 0 0 0 0 0 0 0 0 0 0 0 0 0 0 9 4 4
4 4 4 4 4 4 4 4 4 4 4 4 4 4 4 4 4 4 4 4 4
4 4 4 4 4 4 4 4 4 4 4 4 4 4 4 4 4 4 4 4 4
Ballons
741 167 0
480 121 3
1177 122 2
284 167 0
1064 167 0
536 302 2
1178 230 1
1064 295 0
416 485 0
