21 12
4 4 4 4 4 4 4 4 4 4 4 4 4 4 4 4 4 4 4 4 4 
4 9 0 0 0 0 72 2 0 0 0 0 0 64 64 64 3 64 64 9 4
4 0 0 0 0 0 0 0 0 2 0 0 0 61 62 62 62 61 64 3 4
4 0 0 0 0 0 0 2 2 0 0 0 0 61 0 0 61 61 0 61 4
4 0 0 0 2 2 2 0 0 0 0 0 0 61 61 61 62 62 61 62 4
4 2 2 2 0 0 0 0 0 0 0 0 0 61 61 61 61 61 61 61 4
4 0 0 0 0 0 0 0 0 0 8 0 0 0 0 0 0 0 0 0 4
4 1 0 0 0 0 0 0 0 0 0 0 0 0 0 0 0 0 0 0 4
4 0 2 0 0 0 0 0 0 0 0 0 70 0 0 0 0 0 0 0 4
4 0 2 0 0 0 0 0 0 0 0 0 0 3 3 3 3 3 3 61 4
4 9 64 64 0 0 0 0 0 0 0 0 0 0 0 0 0 0 0 9 4
4 4 4 4 4 4 4 4 4 4 4 4 4 4 4 4 4 4 4 4 4