21 11
4 4 4 4 4 4 4 4 4 4 4 4 4 4 4 4 4 4 4 4 4
4 9 0 0 0 0 0 0 0 7 0 0 0 0 0 0 0 0 9 4 4
4 0 8 0 0 7 0 0 0 0 0 0 0 0 0 0 0 7 0 4 4
4 0 0 0 0 0 0 0 0 4 4 4 4 4 0 0 0 0 0 4 4
4 0 7 0 4 0 0 0 0 0 0 0 2 0 7 0 0 0 0 4 4
4 0 0 0 0 0 0 7 0 0 0 0 4 0 0 0 0 7 0 4 4
4 0 0 0 0 0 0 0 0 0 0 0 4 0 7 0 0 0 0 4 4
4 0 0 0 4 0 0 0 0 4 0 0 0 0 0 0 0 0 0 4 4
4 9 0 0 7 0 0 0 0 0 0 0 0 0 0 0 0 0 9 4 4
4 4 4 4 4 4 4 4 4 4 4 4 4 4 4 4 4 4 4 4 4
4 4 4 4 4 4 4 4 4 4 4 4 4 4 4 4 4 4 4 4 4