20 10
9 0 0 0 0 0 0 0 0 0 0 0 0 0 0 0 0 0 0 9
0 3 0 0 0 0 0 0 0 0 0 0 0 0 0 0 0 0 3 0
0 0 0 0 0 0 0 0 0 0 0 0 0 4 0 0 0 0 0 0
0 0 0 0 4 4 0 0 0 0 0 0 0 4 0 0 0 0 0 0
0 0 0 0 4 8 0 0 0 0 0 0 0 4 0 0 0 0 0 0
0 0 0 0 4 4 4 0 0 0 0 0 0 4 0 0 0 0 0 0
0 0 0 0 0 0 0 0 0 0 0 0 0 4 0 0 0 0 0 0
0 0 0 0 0 0 0 0 0 0 0 0 0 4 0 0 0 0 0 0
0 3 0 0 0 0 0 0 0 0 0 0 0 0 0 0 0 0 3 0
9 0 0 0 0 0 0 0 0 0 0 0 0 0 0 0 0 0 0 9
Ballons
773 442 0
