20 10
4 4 4 4 4 4 4 4 4 4 4 4 4 4 4 4 4 4 4 4
4 9 0 0 0 0 0 0 0 0 0 0 0 0 0 0 0 0 9 4
4 0 8 0 0 0 0 0 0 0 0 0 0 0 0 0 0 0 0 4
4 0 0 0 0 0 0 0 0 4 4 4 4 4 0 0 0 0 0 4
4 0 0 0 4 0 0 0 0 0 0 0 2 0 0 0 0 0 0 4
4 0 0 0 0 0 0 0 0 0 0 0 4 0 0 0 0 0 0 4
4 0 0 0 0 0 0 0 0 0 0 0 4 0 0 0 0 0 0 4
4 0 0 0 4 0 0 0 0 4 0 0 0 0 0 0 0 0 0 4
4 9 0 0 0 0 0 0 0 0 0 0 0 0 0 0 0 0 9 4
4 4 4 4 4 4 4 4 4 4 4 4 4 4 4 4 4 4 4 4
Ballons
764 134 0
506 154 3
1126 155 2
313 134 0
1081 134 0
497 337 2
1127 197 1
1081 262 0
443 452 0
