20 10
4 4 4 4 4 4 4 4 4 4 4 4 4 4 4 4 4 4 4 4
4 9 0 0 0 0 0 0 0 0 0 0 0 0 0 0 0 0 9 4
4 0 8 0 0 0 0 0 0 0 0 0 0 0 0 0 0 0 0 4
4 0 0 0 0 0 0 0 0 4 4 4 4 4 0 0 0 0 0 4
4 0 0 0 4 0 0 0 0 0 0 0 2 0 0 0 0 0 0 4
4 0 0 0 0 0 0 0 0 0 0 0 4 0 0 0 0 0 0 4
4 0 0 0 0 0 0 0 0 0 0 0 4 0 0 0 0 0 0 4
4 0 0 0 4 0 0 0 0 4 0 0 0 0 0 0 0 0 0 4
4 9 0 0 0 0 0 0 0 0 0 0 0 0 0 0 0 0 9 4
4 4 4 4 4 4 4 4 4 4 4 4 4 4 4 4 4 4 4 4
Ballons
870 129 3
509 261 2
1021 261 2
419 131 3
1187 131 3
392 442 2
1022 92 1
1186 157 0
549 346 0
