21 11
4 4 4 4 4 4 4 4 4 0 4 4 4 4 4 4 4 4 4 4 4
4 9 0 0 0 0 0 0 0 0 0 0 0 0 0 0 0 0 9 4 4
4 0 0 0 0 0 0 0 0 0 0 0 0 0 0 0 0 0 0 4 4
4 0 0 0 0 0 0 0 4 2 4 0 0 0 0 0 0 0 0 4 4
4 0 0 0 0 6 0 0 3 0 3 0 0 0 0 0 0 0 0 4 4
4 0 0 0 0 0 0 0 4 0 4 0 0 0 0 0 0 0 0 4 4
4 0 0 0 0 0 0 0 0 8 0 0 0 0 0 0 0 0 0 4 4
4 0 0 0 0 0 0 0 0 0 0 0 0 0 0 0 0 0 0 4 4
4 9 0 0 0 0 0 0 0 0 0 0 0 0 0 0 0 0 9 4 4
4 4 4 4 4 4 4 4 4 4 4 4 4 4 4 4 4 4 4 4 4
4 4 4 4 4 4 4 4 4 4 4 4 4 4 4 4 4 4 4 4 4
Ballons
1161 140 1
