21 11
4 4 4 4 4 4 4 4 4 4 4 4 4 4 4 4 4 4 4 4 4
4 9 0 0 0 0 0 0 0 0 0 0 0 0 0 0 0 0 9 4 4
4 0 0 0 0 0 0 0 0 0 0 0 0 0 0 0 0 0 0 4 4
4 0 0 0 0 0 0 0 0 4 4 4 4 4 0 0 0 0 0 4 4
4 0 0 0 4 0 0 0 0 0 0 0 1 0 0 0 0 0 0 4 4
4 0 8 0 0 0 0 0 0 0 0 0 4 0 0 0 0 0 0 4 4
4 0 0 0 0 0 0 0 0 0 0 0 4 0 0 0 0 0 0 4 4
4 0 0 0 4 0 0 0 0 4 0 0 0 0 0 0 0 0 0 4 4
4 9 0 0 0 0 0 0 0 0 0 0 0 0 0 0 0 0 9 4 4
4 4 4 4 4 4 4 4 4 4 4 4 4 4 4 4 4 4 4 4 4
4 4 4 4 4 4 4 4 4 4 4 4 4 4 4 4 4 4 4 4 4
Ballons
1036 178 0
104 86 2
877 164 2
1139 128 1
361 130 1
572 395 2
757 533 2
1077 257 1
757 343 0
