20 10
4 4 4 4 4 4 4 4 4 4 4 4 4 4 4 4 4 4 4 4
4 9 0 0 0 0 0 0 0 0 0 0 0 0 0 0 0 0 9 4
4 0 8 0 0 0 0 0 0 0 0 0 0 0 0 0 0 0 0 4
4 0 0 0 0 0 0 0 0 4 4 4 4 4 0 0 0 0 0 4
4 0 0 0 4 0 0 0 0 0 0 0 2 0 0 0 0 0 0 4
4 0 0 0 0 0 0 0 0 0 0 0 4 0 0 0 0 0 0 4
4 0 0 0 0 0 0 0 0 0 0 0 4 0 0 0 0 0 0 4
4 0 0 0 4 0 0 0 0 4 0 0 0 0 0 0 0 0 0 4
4 9 0 0 0 0 0 0 0 0 0 0 0 0 0 0 0 0 9 4
4 4 4 4 4 4 4 4 4 4 4 4 4 4 4 4 4 4 4 4
Ballons
996 254 3
383 386 2
896 386 2
545 257 3
1087 258 2
405 551 0
921 196 3
1087 128 2
676 321 3
