20 10
9 0 0 0 0 0 0 0 0 0 0 0 0 0 0 0 0 0 0 9
0 3 0 0 0 0 0 0 0 0 0 0 0 0 0 0 0 0 3 0
0 0 0 0 0 0 0 0 0 0 0 0 0 4 0 0 0 0 0 0
0 0 0 0 4 4 0 0 0 0 0 0 0 4 0 0 0 0 0 0
0 0 0 0 4 0 0 0 0 0 0 0 0 4 0 0 0 0 0 0
0 0 0 0 4 4 4 0 0 0 0 0 0 4 0 0 0 0 8 0
0 0 0 0 0 0 0 0 0 0 0 0 0 4 0 0 0 0 0 0
0 0 0 0 0 0 0 0 0 0 0 0 0 4 0 0 0 0 0 0
0 3 0 0 0 0 0 0 0 0 0 0 0 0 0 0 0 0 3 0
9 0 0 0 0 0 0 0 0 0 0 0 0 0 0 0 0 0 0 0
Ballons
624 144 1
