21 11
4 4 4 4 4 4 4 4 4 4 4 4 4 4 4 4 4 4 4 4 4
4 9 0 0 0 0 0 0 0 0 0 0 0 0 0 0 0 0 9 4 4
4 0 8 0 0 0 0 0 0 0 0 0 0 0 0 0 0 0 0 4 4
4 0 0 0 0 0 0 0 0 4 4 4 4 4 0 0 0 0 0 4 4
4 0 0 0 4 0 0 0 0 0 0 0 2 0 0 0 0 0 0 4 4
4 0 0 0 0 0 0 0 0 0 0 0 4 0 0 0 0 0 0 4 4
4 0 0 0 0 0 0 0 0 0 0 0 4 0 0 0 0 0 0 4 4
4 0 0 0 4 0 0 0 0 4 0 0 0 0 0 0 0 0 0 4 4
4 9 0 0 0 0 0 0 0 0 0 0 0 0 0 0 0 0 9 4 4
4 4 4 4 4 4 4 4 4 4 4 4 4 4 4 4 4 4 4 4 4
4 4 4 4 4 4 4 4 4 4 4 4 4 4 4 4 4 4 4 4 4
Ballons
1029 288 3
350 419 2
862 419 2
578 290 3
1054 291 2
438 518 0
954 229 3
1054 161 2
709 354 3
