21 11
4 4 4 4 4 4 4 4 4 4 4 4 4 4 4 4 4 4 4 4 4
4 9 0 0 0 0 0 0 0 0 0 0 0 0 0 0 0 0 9 4 4
4 0 8 0 0 0 0 0 0 0 0 0 0 0 0 0 0 0 0 4 4
4 0 0 0 0 0 0 0 0 4 4 4 4 4 0 0 0 0 0 4 4
4 0 0 0 4 0 0 0 0 0 0 0 2 0 0 0 0 0 0 4 4
4 0 0 0 0 0 0 0 0 0 0 0 4 0 0 0 0 0 0 4 4
4 0 0 0 0 0 0 0 0 0 0 0 4 0 0 0 0 0 0 4 4
4 0 0 0 4 0 0 0 0 4 0 0 0 0 0 0 0 0 0 4 4
4 9 0 0 0 0 0 0 0 0 0 0 0 0 0 0 0 0 9 4 4
4 4 4 4 4 4 4 4 4 4 4 4 4 4 4 4 4 4 4 4 4
4 4 4 4 4 4 4 4 4 4 4 4 4 4 4 4 4 4 4 4 4
Ballons
734 164 0
477 125 3
1155 126 2
284 163 0
1052 163 0
525 306 2
1157 226 1
1052 292 0
414 481 0
