21 11
4 4 4 4 4 4 4 4 4 0 4 4 4 4 4 4 4 4 4 4 4
4 9 0 0 0 0 0 0 0 0 0 0 0 0 0 0 0 0 9 4 4
4 0 0 0 0 0 0 0 0 0 0 0 0 0 0 0 0 0 0 4 4
4 0 0 0 0 0 0 0 4 2 4 0 0 0 0 0 0 0 0 4 4
4 0 0 0 0 63 0 0 3 8 3 0 0 0 0 0 0 0 0 4 4
4 0 0 0 0 0 0 0 4 1 4 0 0 0 0 0 0 0 0 4 4
4 0 0 0 0 73 0 0 0 0 0 0 0 0 0 0 0 0 0 4 4
4 0 0 0 0 0 0 0 0 0 0 0 0 0 0 0 0 0 0 4 4
4 9 0 0 0 0 0 0 0 0 0 0 0 0 0 0 0 0 9 4 4
4 4 4 4 4 4 4 4 4 4 4 4 4 4 4 4 4 4 4 4 4
4 4 4 4 4 4 4 4 4 4 4 4 4 4 4 4 4 4 4 4 4