20 10
0 0 0 0 0 0 0 0 0 0 0 0 0 0 0 0 0 0 0 0
4 9 0 0 0 0 0 0 0 0 0 0 0 0 0 0 0 0 9 0
4 0 0 0 0 0 0 0 0 0 0 0 0 0 0 0 0 0 0 4
4 0 0 0 0 0 0 0 0 0 0 0 0 0 0 0 0 0 0 4
4 0 0 0 0 8 0 0 0 0 0 0 0 0 0 0 0 0 0 4
4 0 0 0 0 0 0 0 0 0 0 0 0 0 0 0 0 0 0 4
4 0 0 0 0 0 0 0 0 0 0 0 0 0 0 0 0 0 0 4
4 0 0 0 0 0 0 0 0 0 0 0 0 0 0 0 0 0 0 4
4 9 0 0 0 0 0 0 0 0 0 0 0 0 0 0 0 0 9 4
0 0 0 0 0 0 0 0 0 0 0 0 0 0 0 0 0 0 0 0
Ballons
558 174 1
